TILEMAP
40 80
16 16
images/TilesetGlobal.png
100 88
8025 8028 8028 8028 8028 8126 8028 8028 8028 8028 8028 8028 8028 8028 8028 8028 8028 8126 8028 8028 8028 8028 8028 8028 8028 8028 8028 8028 8028 8028 8028 8028 8028 8028 8028 8028 8028 8028 8028 8029
8125 8311 8312 8312 8312 8312 8312 8312 8312 8312 8312 8312 8312 8312 8312 8312 8312 8312 8312 8312 8312 8312 8312 8312 8312 8312 8312 8312 8312 8312 8312 8312 8312 8312 8312 8312 8312 8312 8313 8129
8125 8411 8412 8412 8412 8412 8412 8412 8412 8412 8412 8412 8412 8412 8412 8412 8412 8412 8412 8412 8412 8412 8412 8412 8412 8412 8412 8412 8412 8412 8412 8412 8412 8412 8412 8412 8412 8412 8413 8129
8125 8411 8412 8412 8412 8512 8512 8512 8512 8512 8512 8512 8512 8512 8512 8512 8512 8512 8512 8512 8512 8512 8512 8512 8512 8512 8512 8412 8412 8412 8412 8412 8412 8412 8412 8412 8412 8412 8413 8129
8125 8411 8412 8412 8044 8542 8542 8542 8542 8542 8542 8542 8542 8542 8542 8441 8542 8542 8542 8045 8040 8411 8412 8412 8412 8412 8412 8412 8412 8412 8412 8412 8412 8412 8412 8412 8412 8412 8413 8045
8125 8411 8412 8412 8412 8412 8412 8412 8412 8412 8412 8412 8412 8412 8412 8412 8412 8412 8412 8129 8125 8411 8412 8412 8412 8412 8412 8412 8412 8412 8412 8412 8412 8412 8412 8412 8412 8412 8413 8129
8125 8411 8412 8412 8412 8412 8412 8412 8412 8412 8412 8412 8412 8412 8412 8412 8412 8412 8413 8129 8125 8411 8412 8412 8412 8412 8412 8412 8412 8412 8412 8412 8412 8412 8412 8412 8412 8412 8413 8129
8125 8411 8412 8412 8412 8412 8412 8412 8412 8412 8412 8412 8412 8412 8412 8412 8412 8412 8413 8129 8125 8411 8412 8412 8412 8412 8412 8412 8412 8412 8412 8412 8412 8412 8412 8412 8412 8412 8413 8129
8125 8411 8412 8412 8412 8412 8412 8412 8412 8412 8412 8412 8412 8412 8412 8412 8412 8412 8413 8129 8125 8411 8412 8412 8412 8412 8412 8412 8412 8412 8412 8412 8412 8412 8412 8412 8412 8412 8413 8129
8125 8411 8412 8412 8412 8412 8412 8412 8412 8412 8412 8412 8412 8412 8412 8412 8412 8412 8413 8129 8125 8511 8512 8417 8412 8412 8412 8412 8412 8412 8412 8412 8412 8412 8412 8412 8416 8512 8513 8129
8125 8411 8412 8412 8412 8412 8412 8412 8412 8412 8412 8412 8412 8412 8412 8412 8412 8412 8413 8129 8125 7926 7926 8411 8412 8412 8412 8412 8412 8412 8412 8412 8412 8412 8412 8412 8413 7926 7926 8129
8125 8411 8412 8412 8412 8412 8412 8412 8412 8412 8412 8412 8412 8412 8412 8412 8412 8412 8413 8129 8125 7926 7926 8411 8412 8412 8412 8412 8412 8412 8412 8412 8412 8412 8412 8412 8413 7926 7926 8129
8125 8411 8412 8412 8412 8412 8412 8412 8412 8412 8412 8412 8412 8412 8412 8412 8412 8412 8413 8129 8125 7926 7926 8411 8412 8412 8412 8412 8412 8412 8412 8412 8412 8412 8412 8412 8413 7926 7926 8129
8125 8411 8412 8412 8412 8412 8412 8412 8412 8412 8412 8412 8412 8412 8412 8412 8412 8412 8413 8129 8125 7926 7926 8411 8412 8412 8412 8412 8412 8412 8412 8412 8412 8412 8412 8412 8413 7926 7926 8129
8125 8411 8412 8412 8412 8412 8412 8412 8412 8412 8412 8412 8412 8412 8412 8412 8412 8412 8413 8129 8125 7926 7926 8411 8412 8412 8412 8412 8412 8412 8412 8412 8412 8412 8412 8412 8413 7926 7926 8129
8125 8411 8412 8412 8412 8412 8412 8412 8412 8412 8412 8412 8412 8412 8412 8412 8412 8412 8413 8129 8125 7926 7926 8411 8412 8412 8412 8412 8412 8412 8412 8412 8412 8412 8412 8412 8413 7926 7926 8129
8125 8411 8412 8412 8412 8412 8412 8412 8412 8412 8412 8412 8412 8412 8412 8412 8412 8412 8413 8129 8125 7926 7926 8411 8412 8412 8412 8412 8412 8412 8412 8412 8412 8412 8412 8412 8413 7926 7926 8129
8125 8411 8412 8412 8412 8412 8412 8412 8412 8412 8412 8412 8412 8412 8412 8412 8412 8412 8413 8129 8125 7926 7926 8411 8412 8412 8412 8412 8412 8412 8412 8412 8412 8412 8412 8412 8413 7926 7926 8129
8125 8411 8412 8412 8412 8412 8412 8412 8412 8412 8412 8412 8412 8412 8412 8412 8412 8412 8413 8129 8125 8311 8312 8517 8412 8412 8412 8412 8412 8412 8412 8412 8412 8412 8412 8412 8516 8312 8313 8129
8125 8411 8412 8412 8412 8412 8412 8412 8412 8412 8412 8412 8412 8412 8412 8412 8412 8412 8413 8129 8125 8411 8412 8412 8412 8412 8412 8412 8412 8412 8412 8412 8412 8412 8412 8412 8412 8412 8413 8129
8125 8411 8412 8412 8412 8412 8412 8412 8412 8412 8412 8412 8412 8412 8412 8412 8412 8412 8413 8129 8125 8411 8412 8412 8412 8412 8412 8412 8412 8412 8412 8412 8412 8412 8412 8412 8412 8412 8413 8129
8125 8411 8412 8412 8412 8412 8412 8412 8412 8412 8412 8412 8412 8412 8412 8412 8412 8412 8413 8129 8125 8411 8412 8412 8412 8412 8412 8412 8412 8412 8412 8412 8412 8412 8412 8412 8412 8412 8413 8129
8125 8411 8412 8412 8412 8412 8412 8412 8412 8412 8412 8412 8412 8412 8412 8412 8412 8412 8413 8129 8125 8411 8412 8412 8412 8412 8412 8412 8412 8412 8412 8412 8412 8412 8412 8412 8412 8412 8413 8129
8040 8542 8542 8542 8542 8542 8542 8542 8542 8542 8542 8412 8412 8412 8412 8412 8412 8412 8413 8129 8125 8411 8412 8412 8412 8412 8412 8412 8412 8412 8412 8412 8412 8412 8412 8412 8412 8412 8413 8129
8125 8411 8412 8412 8412 8412 8412 8412 8412 8412 8412 8412 8412 8412 8412 8412 8412 8412 8413 8129 8125 8411 8412 8416 8512 8512 8512 8512 8512 8512 8512 8512 8512 8512 8512 8512 8512 8512 8513 8129
8125 8411 8412 8412 8412 8412 8412 8412 8412 8412 8412 8412 8412 8412 8412 8412 8412 8412 8413 8129 8125 8411 8412 8413 7927 7927 7927 7927 7927 7927 7927 7927 7927 7927 7927 7927 7927 7927 7927 8129
8125 8411 8412 8412 8412 8412 8412 8412 8412 8412 8412 8412 8412 8412 8412 8412 8412 8412 8413 8129 8125 8411 8412 8413 7927 7927 7927 7927 7927 7927 7927 7927 7927 7927 7927 7927 7927 7927 7927 8129
8125 8411 8412 8412 8412 8412 8412 8412 8412 8412 8412 8412 8412 8412 8412 8412 8412 8412 8413 8129 8125 8411 8412 8516 8312 8312 8312 8312 8312 8312 8312 8312 8312 8312 8312 8312 8312 8312 8313 8129
8125 8411 8412 8412 8412 8412 8412 8412 8412 8412 8412 8412 8412 8412 8412 8412 8412 8412 8413 8145 8125 8411 8412 8412 8412 8412 8412 8412 8412 8412 8412 8412 8412 8412 8412 8412 8412 8412 8413 8129
8125 8411 8412 8412 8044 8542 8542 8542 8542 8542 8542 8540 8540 8540 8540 8540 8540 8540 8540 8045 8125 8511 8512 8512 8512 8512 8512 8512 8512 8512 8512 8512 8512 8512 8512 8512 8412 8412 8413 8129
8125 8411 8412 8412 8412 8412 8412 8412 8412 8412 8412 8412 8412 8412 8412 8412 8412 8412 8413 8129 8125 7927 7927 7927 7927 7927 7927 7927 7927 7927 7927 7927 7927 7927 7927 7927 8411 8412 8413 8129
8125 8411 8412 8412 8412 8412 8412 8412 8412 8412 8412 8412 8412 8412 8412 8412 8412 8412 8413 8129 8125 7927 7927 7927 7927 7927 7927 7927 7927 7927 7927 7927 7927 7927 7927 7927 8411 8412 8413 8129
8125 8411 8412 8412 8412 8412 8412 8412 8412 8412 8412 8412 8412 8412 8412 8412 8412 8412 8413 8129 8125 8311 8312 8312 8312 8312 8312 8312 8312 8312 8312 8312 8312 8312 8312 8312 8517 8412 8413 8129
8125 8411 8412 8412 8412 8412 8412 8412 8412 8412 8412 8412 8412 8412 8412 8412 8412 8412 8413 8129 8125 8411 8412 8412 8412 8412 8412 8412 8412 8412 8412 8412 8412 8412 8412 8412 8412 8412 8413 8129
8125 8411 8412 8412 8412 8412 8412 8412 8412 8412 8412 8412 8412 8412 8412 8412 8412 8412 8413 8129 8125 8411 8412 8416 8512 8512 8512 8512 8512 8512 8512 8512 8512 8512 8512 8512 8512 8512 8513 8129
8125 8411 8412 8412 8412 8412 8412 8412 8412 8412 8412 8412 8412 8412 8412 8412 8412 8412 8413 8129 8125 8411 8412 8413 7927 7927 7927 7927 7927 7927 7927 7927 7927 7927 7927 7927 7927 7927 7927 8129
8125 8411 8412 8412 8412 8412 8412 8412 8412 8412 8412 8412 8412 8412 8412 8412 8412 8412 8413 8129 8125 8411 8412 8413 7927 7927 7927 7927 7927 7927 7927 7927 7927 7927 7927 7927 7927 7927 7927 8129
8125 8411 8412 8412 8412 8412 8412 8412 8412 8412 8412 8412 8412 8412 8412 8412 8412 8412 8413 8129 8125 8411 8412 8516 8312 8312 8312 8312 8312 8312 8312 8312 8312 8312 8312 8312 8312 8312 8312 8129
8125 8511 8512 8512 8512 8512 8512 8512 8512 8512 8512 8512 8512 8512 8512 8512 8512 8512 8513 8129 8125 8511 8512 8512 8512 8512 8512 8512 8512 8512 8512 8512 8512 8512 8512 8512 8417 8412 8413 8129
8425 8428 8428 8428 8428 8428 8428 8428 8428 8428 8428 8428 8428 8428 8428 8428 8428 8428 8428 8429 8425 8428 8428 8428 8428 8428 8428 8428 8428 8428 8428 8428 8428 8428 8428 8412 8411 8412 8413 8429
8025 8028 8028 8028 8028 8028 8028 8028 8028 8028 8028 8028 8028 8028 8028 8028 8028 8028 8028 8029 8025 8028 8028 8028 8028 8028 8028 8028 8028 8028 8028 8028 8028 8028 8028 8412 8411 8412 8413 8029
8125 8412 8312 8312 8312 8312 8312 8312 8312 8312 8312 8312 8312 8312 8312 8312 8312 8312 8313 8129 8125 8412 8312 8312 8312 8312 8312 8312 8312 8312 8312 8312 8312 8312 8312 8312 8517 8412 8413 8129
8125 8411 8412 8412 8412 8412 8412 8412 8412 8412 8412 8412 8412 8412 8412 8412 8412 8412 8413 8129 8125 8411 8412 8412 8412 8412 8412 8412 8412 8412 8412 8412 8412 8412 8412 8412 8412 8412 8413 8129
8125 8411 8412 8412 8412 8412 8412 8412 8412 8412 8412 8412 8412 8412 8412 8412 8412 8412 8413 8129 8125 8411 8412 8412 8412 8412 8412 8412 8412 8412 8412 8412 8412 8412 8412 8412 8412 8412 8413 8129
8125 8411 8412 8412 8412 8412 8412 8412 8412 8412 8412 8412 8412 8412 8412 8412 8412 8412 8413 8129 8040 8542 8542 8041 8412 8412 8412 8412 8412 8412 8412 8412 8412 8412 8412 8412 8412 8412 8413 8045
8125 8411 8412 8412 8412 8412 8412 8412 8412 8412 8412 8412 8412 8412 8412 8412 8412 8412 8413 8129 8125 8411 8412 8412 8412 8412 8412 8412 8412 8412 8412 8412 8412 8412 8412 8412 8412 8412 8413 8129
8125 8411 8412 8412 8412 8412 8412 8412 8412 8412 8412 8412 8412 8412 8412 8412 8412 8412 8413 8129 8125 8411 8412 8412 8412 8412 8412 8412 8412 8412 8412 8412 8412 8412 8412 8412 8412 8412 8413 8129
8125 8411 8412 8412 8412 8412 8412 8412 8412 8412 8412 8412 8412 8412 8412 8412 8412 8412 8413 8129 8125 8411 8412 8412 8412 8412 8412 8412 8412 8412 8412 8412 8412 8412 8412 8412 8412 8412 8413 8129
8125 8411 8412 8412 8412 8412 8412 8412 8412 8412 8412 8412 8412 8412 8412 8412 8412 8412 8413 8129 8040 8542 8542 8542 8542 8542 8542 8542 8542 8542 8542 8542 8542 8041 8412 8412 8044 8542 8542 8045
8125 8411 8412 8412 8412 8412 8412 8412 8412 8412 8412 8412 8412 8412 8412 8412 8412 8412 8413 8129 8125 8411 8412 8412 8412 8412 8412 8412 8412 8412 8412 8412 8412 8412 8412 8412 8412 8412 8413 8129
8125 8411 8412 8412 8412 8412 8412 8412 8412 8412 8412 8412 8412 8412 8412 8412 8412 8412 8413 8129 8125 8411 8412 8412 8412 8412 8412 8412 8412 8412 8412 8412 8412 8412 8412 8412 8412 8412 8413 8129
8125 8411 8412 8412 8412 8412 8412 8412 8412 8412 8412 8412 8412 8412 8412 8412 8412 8412 8413 8129 8125 8411 8412 8412 8412 8412 8412 8412 8412 8412 8412 8412 8412 8412 8412 8412 8412 8412 8413 8129
8125 8411 8412 8412 8412 8412 8412 8412 8412 8412 8412 8412 8412 8412 8412 8412 8412 8412 8413 8129 8040 8542 8542 8041 8412 8412 8412 8542 8542 8542 8542 8542 8542 8542 8542 8542 8542 8542 8542 8045
8125 8411 8412 8412 8412 8412 8412 8412 8412 8412 8412 8412 8412 8412 8412 8412 8412 8412 8413 8129 8125 8411 8412 8412 8412 8412 8412 8412 8412 8412 8412 8412 8412 8412 8412 8412 8412 8412 8413 8129
8125 8411 8412 8412 8412 8412 8412 8412 8412 8412 8412 8412 8412 8412 8412 8412 8412 8412 8413 8129 8125 8411 8412 8412 8412 8412 8412 8412 8412 8412 8412 8412 8412 8412 8412 8412 8412 8412 8413 8129
8125 8411 8412 8412 8412 8412 8412 8412 8412 8412 8412 8412 8412 8412 8412 8412 8412 8412 8413 8129 8125 8411 8412 8412 8412 8412 8412 8412 8412 8412 8412 8412 8412 8412 8412 8412 8412 8412 8413 8129
8125 8411 8412 8412 8412 8412 8412 8412 8412 8412 8412 8412 8412 8412 8412 8412 8412 8412 8413 8129 8040 8542 8542 8542 8542 8542 8542 8542 8542 8542 8542 8542 8542 8041 8412 8412 8044 8542 8542 8045
8125 8411 8412 8412 8412 8412 8412 8412 8412 8412 8412 8412 8412 8412 8412 8412 8412 8412 8413 8129 8125 8411 8412 8412 8412 8412 8412 8412 8412 8412 8412 8412 8412 8412 8412 8412 8412 8412 8413 8129
8125 8411 8412 8412 8412 8412 8412 8412 8412 8412 8412 8412 8412 8412 8412 8412 8412 8412 8413 8129 8125 8411 8412 8412 8412 8412 8412 8412 8412 8412 8412 8412 8412 8412 8412 8412 8412 8412 8413 8129
8125 8411 8412 8412 8412 8412 8412 8412 8412 8412 8412 8412 8412 8412 8412 8412 8412 8412 8413 8129 8125 8411 8412 8412 8412 8412 8412 8412 8412 8412 8412 8412 8412 8412 8412 8412 8412 8412 8413 8129
8040 8411 8412 8412 8412 8412 8412 8412 8412 8412 8412 8412 8412 8412 8412 8412 8412 8412 8413 8045 8125 8411 8412 8412 8412 8412 8412 8412 8412 8412 8412 8412 8412 8412 8412 8412 8412 8412 8413 8129
8125 8411 8412 8412 8412 8412 8412 8412 8412 8412 8412 8412 8412 8412 8412 8412 8412 8412 8413 8129 8125 8411 8412 8412 8412 8412 8412 8412 8412 8412 8412 8412 8412 8412 8412 8412 8412 8412 8413 8129
8125 8411 8412 8412 8412 8412 8412 8412 8412 8412 8412 8412 8412 8412 8412 8412 8412 8412 8413 8129 8125 8411 8412 8412 8412 8412 8412 8412 8412 8412 8412 8412 8412 8412 8412 8412 8412 8412 8413 8129
8125 8411 8412 8412 8412 8412 8412 8412 8412 8412 8412 8412 8412 8412 8412 8412 8412 8412 8413 8129 8125 8411 8412 8412 8412 8412 8412 8412 8412 8412 8412 8412 8412 8412 8412 8412 8412 8412 8413 8129
8125 8411 8412 8412 8412 8412 8412 8412 8412 8412 8412 8412 8412 8412 8412 8412 8412 8412 8413 8129 8125 8411 8412 8412 8412 8412 8412 8412 8412 8412 8412 8412 8412 8412 8412 8412 8412 8412 8413 8129
8125 8411 8412 8412 8412 8412 8412 8412 8412 8412 8412 8412 8412 8412 8412 8412 8412 8412 8413 8129 8125 8411 8412 8412 8412 8412 8412 8412 8412 8412 8412 8412 8412 8412 8412 8412 8412 8412 8413 8129
8125 8411 8412 8412 8412 8412 8412 8412 8412 8412 8412 8412 8412 8412 8412 8412 8412 8412 8413 8129 8125 8411 8412 8412 8412 8412 8412 8412 8412 8412 8412 8412 8412 8412 8412 8412 8412 8412 8413 8129
8125 8411 8412 8412 8412 8412 8412 8412 8412 8412 8412 8412 8412 8412 8412 8412 8412 8412 8413 8129 8125 8411 8412 8412 8412 8412 8412 8412 8412 8412 8412 8412 8412 8412 8412 8412 8412 8412 8413 8129
8125 8411 8412 8412 8412 8412 8412 8412 8412 8412 8412 8412 8412 8412 8412 8412 8412 8412 8413 8129 8125 8411 8412 8412 8412 8412 8412 8412 8412 8412 8412 8412 8412 8412 8412 8412 8412 8412 8413 8129
8125 8411 8412 8412 8412 8412 8412 8412 8412 8412 8412 8412 8412 8412 8412 8412 8412 8412 8413 8129 8125 8411 8412 8412 8412 8412 8412 8412 8412 8412 8412 8412 8412 8412 8412 8412 8412 8412 8413 8129
8125 8411 8412 8412 8412 8412 8412 8412 8412 8412 8412 8412 8412 8412 8412 8412 8412 8412 8413 8129 8125 8411 8412 8412 8412 8412 8412 8412 8412 8412 8412 8412 8412 8412 8412 8412 8412 8412 8413 8129
8125 8411 8412 8412 8412 8412 8412 8412 8412 8412 8412 8412 8412 8412 8412 8412 8412 8412 8413 8129 8125 8411 8412 8412 8412 8412 8412 8412 8412 8412 8412 8412 8412 8412 8412 8412 8412 8412 8413 8129
8125 8411 8412 8412 8412 8412 8412 8412 8412 8412 8412 8412 8412 8412 8412 8412 8412 8412 8413 8129 8125 8411 8412 8412 8412 8412 8412 8412 8412 8412 8412 8412 8412 8412 8412 8412 8412 8412 8413 8129
8125 8411 8412 8412 8412 8412 8412 8412 8412 8412 8412 8412 8412 8412 8412 8412 8412 8412 8413 8129 8125 8411 8412 8412 8412 8412 8412 8412 8412 8412 8412 8412 8412 8412 8412 8412 8412 8412 8413 8129
8125 8411 8412 8412 8412 8412 8412 8412 8412 8412 8412 8412 8412 8412 8412 8412 8412 8412 8413 8129 8125 8411 8412 8412 8412 8412 8412 8412 8412 8412 8412 8412 8412 8412 8412 8412 8412 8412 8413 8129
8125 8411 8412 8412 8412 8412 8412 8412 8412 8412 8412 8412 8412 8412 8412 8412 8412 8412 8413 8412 8440 8411 8412 8412 8412 8412 8412 8412 8412 8412 8412 8412 8412 8412 8412 8412 8412 8412 8413 8129
8125 8411 8412 8412 8412 8412 8412 8412 8412 8412 8412 8412 8412 8412 8412 8412 8412 8412 8516 8312 8312 8312 8412 8412 8412 8412 8412 8412 8412 8412 8412 8412 8412 8412 8412 8412 8412 8412 8413 8129
8125 8411 8412 8412 8412 8412 8412 8412 8412 8412 8412 8412 8412 8412 8412 8412 8412 8412 8412 8412 8412 8412 8412 8412 8412 8412 8412 8412 8412 8412 8412 8412 8412 8412 8412 8412 8412 8412 8413 8129
8125 8511 8512 8512 8512 8512 8512 8512 8512 8512 8512 8512 8512 8512 8512 8512 8512 8512 8512 8512 8512 8512 8512 8512 8512 8512 8512 8512 8512 8512 8512 8512 8512 8512 8512 8512 8512 8512 8513 8129
8425 8428 8428 8428 8428 8428 8428 8428 8428 8428 8428 8428 8428 8428 8428 8428 8428 8428 8428 8428 8428 8428 8428 8428 8428 8428 8428 8428 8428 8428 8428 8428 8428 8428 8428 8428 8428 8428 8428 8429
