TILEMAP
20 20 							-- Size of tile map in tiles
16 16 -- Tile size & block size
images/ui/menu_tiles.png 	-- Tilesheet
61 22 								-- Number of tiles in tilesheet

62 63 63 63 63 63 63 63 63 63 63 63 63 63 63 63 63 63 63 70
123 124 125 125 125 125 125 125 125 125 125 125 125 125 125 125 125 125 130 131
428 429 186 186 186 186 186 186 186 186 186 186 186 186 186 186 186 186 191 192
428 429 186 186 186 186 186 186 186 186 186 186 186 186 186 186 186 186 191 192
428 185 186 186 186 186 186 186 186 186 186 186 186 186 186 186 186 186 191 192
428 429 186 186 369 186 186 186 186 186 186 186 186 186 186 186 186 186 191 192
428 429 186 186 369 369 369 369 186 186 186 369 369 369 186 186 186 369 191 192
428 429 249 369 369 369 369 369 369 369 369 369 369 369 369 369 369 369 191 192
428 429 249 369 369 369 369 369 369 369 369 369 369 369 369 369 369 369 191 192
428 429 249 369 369 369 369 369 369 369 369 369 369 369 369 369 369 369 191 192
428 429 249 369 369 369 369 369 369 369 369 369 369 369 369 369 369 369 191 192
428 429 249 369 369 369 369 369 369 369 369 369 369 369 369 369 369 369 191 192
428 429 249 369 369 369 369 369 369 369 369 369 369 369 369 369 369 369 191 192
428 429 249 369 369 369 369 369 369 369 369 369 369 369 369 309 309 309 374 192
428 429 249 369 369 369 369 369 369 369 309 309 369 369 369 369 309 309 374 192
428 429 249 249 309 309 309 309 309 309 309 309 309 309 309 309 309 309 191 192
428 429 249 249 309 309 309 309 309 309 309 309 309 309 309 309 309 309 191 192
428 429 249 309 309 309 309 309 309 309 309 309 309 309 309 309 309 309 435 192
489 490 491 495 495 495 495 495 495 495 495 495 495 495 495 495 495 495 496 497
550 557 557 557 557 557 557 557 557 557 557 557 557 557 557 557 557 557 557 558

