TILEMAP
20 20 							-- Size of tile map in tiles
16 16 -- Tile size & block size
images/TilesetFloor.png 	-- Tilesheet
22 26 								-- Number of tiles in tilesheet

0 1 1 1 1 1 1 1 1 1 1 1 1 1 1 1 1 1 1 1
22 110 111 112 112 0 1 2 89 89 88 88 88 88 88 88 88 88 88 88
22 110 111 112 112 22 23 24 89 89 88 88 88 88 88 88 88 88 88 88
22 110 89 89 112 88 45 46 89 88 88 88 88 88 88 88 88 88 88 88
22 110 111 89 112 88 88 88 88 88 88 88 88 88 88 88 88 88 88 88
22 110 111 89 89 88 88 88 88 88 88 88 88 88 88 88 88 88 88 88
22 110 111 88 88 88 88 88 88 88 88 88 88 88 88 88 88 88 88 88
22 110 111 88 88 88 88 88 88 88 88 88 88 88 88 88 88 88 88 88
22 110 111 112 112 88 88 88 88 88 89 89 88 88 88 88 88 88 88 88
22 110 111 112 88 88 88 88 88 88 88 89 89 89 88 88 88 88 88 88
22 110 111 88 88 88 88 88 88 88 88 88 88 88 88 88 88 88 88 88
22 110 111 88 112 88 88 88 88 88 88 88 88 88 88 88 88 88 88 88
22 110 111 88 88 88 88 88 88 88 88 88 88 88 88 88 88 88 88 88
22 110 111 88 88 88 88 88 88 88 88 88 88 88 88 88 88 88 88 88
22 110 89 89 112 88 88 88 88 88 88 88 88 88 88 88 88 88 88 88
22 110 89 112 112 88 88 88 88 88 88 88 88 88 88 88 88 88 88 88
22 110 89 89 112 88 88 88 88 88 88 88 88 88 88 88 88 88 88 88
22 110 111 89 112 88 88 88 88 88 88 88 88 88 88 88 88 88 88 88
22 110 111 112 112 88 88 88 88 88 88 88 88 88 88 88 88 88 88 88
44 45 45 45 45 45 45 45 45 45 45 45 45 45 45 45 45 45 45 45

