TILEMAP
60 80
16 16
images/TilesetGlobal.png
100 88
5588 5589 5387 5387 5387 5387 5387 5387 5387 5387 5387 5387 5387 5387 5387 -1 5486 5487 5486 5487 -1 5387 5387 5387 5387 5387 5387 5387 5387 5387 5387 5387 5387 -1 -1 -1 2810 -1 -1 2910 -1 4693 4694 4695 -1 -1 -1 -1 5283 5284 5283 5284 5390 5195 5196 5197 5198 5195 5196 5197
5688 5689 5184 5184 -1 4983 4983 -1 -1 5585 5585 5585 5585 -1 -1 -1 5586 5587 5586 5587 -1 -1 4981 4979 4980 4981 -1 5585 -1 4679 4680 4681 4682 -1 -1 -1 2910 5400 5400 2910 -1 4793 4794 4795 -1 -1 -1 -1 5383 5384 5383 5384 5490 5295 5296 5297 5298 5295 5296 5297
5184 5184 5184 5184 -1 5083 5083 -1 -1 5685 5685 5685 5685 -1 -1 -1 5686 5687 5686 5687 -1 -1 5081 5079 5080 5081 -1 5685 -1 4779 4780 4781 4782 -1 -1 -1 2910 5500 5500 2910 -1 4893 4894 4895 -1 -1 -1 -1 -1 -1 -1 -1 5390 5395 5396 5397 5398 5395 5396 5397
51 52 -1 -1 -1 -1 -1 -1 -1 -1 -1 -1 -1 -1 -1 -1 5786 5787 5786 5787 -1 -1 5181 -1 -1 5181 -1 -1 -1 4879 4880 4881 4882 -1 -1 -1 3011 2812 2812 3012 -1 4993 4994 4995 -1 -1 -1 -1 -1 -1 -1 -1 5490 5495 5496 5497 5498 5495 5496 5497
151 152 -1 -1 -1 -1 -1 -1 -1 -1 -1 -1 -1 -1 -1 -1 -1 -1 -1 -1 -1 -1 -1 -1 -1 -1 -1 -1 -1 5180 5180 5180 -1 -1 -1 -1 3111 -1 -1 -1 -1 5093 5094 5095 -1 -1 -1 -1 -1 -1 -1 -1 5390 5595 5596 5597 5598 5595 5596 5597
51 52 5184 5184 -1 -1 -1 -1 -1 -1 -1 -1 -1 -1 -1 -1 -1 -1 -1 -1 -1 5184 -1 -1 -1 -1 -1 -1 -1 -1 -1 -1 -1 -1 -1 -1 -1 -1 -1 -1 -1 -1 -1 -1 -1 -1 -1 -1 -1 -1 -1 -1 5490 3505 3505 3506 3506 3506 3505 3505
151 152 5184 5184 -1 -1 -1 -1 -1 -1 -1 -1 -1 -1 -1 -1 -1 -1 -1 -1 -1 5184 -1 -1 -1 5086 -1 -1 -1 -1 -1 -1 -1 -1 -1 -1 -1 -1 -1 -1 -1 -1 -1 -1 -1 -1 -1 -1 -1 -1 -1 -1 -1 -1 -1 -1 -1 -1 -1 -1
51 52 5184 -1 -1 -1 -1 -1 -1 -1 -1 -1 -1 -1 -1 -1 -1 -1 -1 -1 -1 -1 -1 -1 -1 -1 -1 -1 -1 -1 -1 -1 -1 -1 -1 -1 -1 -1 -1 -1 -1 -1 -1 -1 -1 -1 -1 -1 -1 -1 -1 -1 -1 -1 -1 -1 -1 -1 -1 -1
151 152 -1 -1 -1 -1 -1 -1 -1 -1 -1 -1 -1 -1 -1 -1 -1 -1 -1 -1 -1 -1 -1 -1 -1 -1 -1 -1 -1 -1 -1 -1 5388 5389 -1 -1 -1 -1 -1 -1 -1 -1 -1 -1 -1 -1 -1 -1 -1 -1 -1 -1 -1 -1 -1 -1 -1 -1 -1 -1
51 52 -1 -1 -1 -1 -1 -1 -1 -1 -1 -1 -1 -1 -1 -1 -1 -1 -1 -1 -1 -1 -1 -1 -1 -1 -1 -1 -1 -1 -1 -1 5488 5489 -1 -1 -1 -1 -1 -1 -1 -1 -1 -1 -1 -1 -1 -1 -1 -1 -1 -1 -1 -1 -1 -1 -1 -1 -1 -1
151 152 -1 -1 -1 -1 -1 -1 -1 -1 -1 -1 -1 -1 -1 -1 -1 -1 -1 -1 -1 -1 -1 -1 -1 -1 -1 -1 -1 -1 -1 -1 -1 -1 -1 -1 -1 -1 -1 -1 -1 -1 -1 -1 -1 -1 -1 -1 -1 -1 -1 -1 -1 -1 2811 2812 2813 2811 2812 2813
51 52 5283 5284 -1 -1 -1 -1 -1 -1 -1 -1 -1 -1 -1 -1 -1 -1 -1 -1 -1 -1 -1 -1 -1 -1 -1 -1 -1 -1 -1 -1 -1 -1 -1 -1 -1 -1 -1 -1 -1 -1 -1 -1 -1 -1 -1 -1 -1 -1 -1 -1 -1 -1 -1 -1 -1 -1 -1 -1
151 152 5383 5384 -1 -1 -1 -1 -1 -1 -1 -1 -1 -1 -1 -1 -1 -1 -1 -1 -1 -1 -1 -1 -1 -1 -1 -1 -1 -1 -1 -1 -1 -1 -1 -1 -1 -1 -1 -1 -1 5486 5487 5486 5487 -1 -1 -1 -1 -1 -1 -1 -1 -1 -1 -1 -1 -1 -1 -1
51 52 5183 5183 5183 -1 -1 -1 -1 -1 -1 -1 -1 -1 -1 -1 -1 -1 -1 -1 -1 -1 -1 -1 -1 -1 -1 -1 -1 -1 -1 -1 -1 -1 -1 -1 -1 -1 -1 -1 -1 5586 5587 5586 5587 -1 -1 -1 -1 -1 -1 -1 -1 -1 -1 -1 -1 -1 -1 -1
151 152 5183 5183 -1 5195 5196 5197 5198 5283 5284 5283 5284 5283 5284 -1 837 838 837 838 -1 -1 -1 5180 -1 5200 -1 5180 -1 -1 -1 -1 -1 5585 4679 4680 4681 4682 5585 -1 -1 5686 5687 5686 5687 -1 -1 5729 5730 5730 5730 5730 5731 -1 -1 -1 -1 -1 -1 -1
51 52 5183 5183 -1 5295 5296 5297 5298 5383 5384 5383 5384 5383 5384 -1 937 938 937 938 -1 -1 -1 5180 3313 5300 -1 5180 -1 -1 -1 -1 -1 5685 4779 4780 4781 4782 5685 -1 -1 5786 5787 5786 5787 -1 -1 5829 5830 5830 5830 5830 5831 -1 -1 -1 -1 5924 5925 -1
151 152 5183 5183 -1 5395 5396 5397 5398 5183 5183 5183 5183 5183 5184 5183 5183 5183 5183 5183 -1 -1 5180 4981 4687 4688 -1 4981 5180 -1 -1 -1 -1 -1 4879 4880 4881 4882 -1 -1 -1 -1 -1 -1 -1 -1 -1 5929 5930 5930 5930 5930 5931 -1 -1 -1 -1 6024 6025 -1
53 54 5183 5183 5183 5495 5496 5497 5498 5183 5183 5183 5183 5183 5183 5183 5183 5183 5183 5183 -1 -1 -1 5081 4787 4788 4789 5081 -1 -1 -1 -1 -1 5585 5180 5180 5180 -1 5585 -1 3309 3309 3309 3309 3309 3309 3309 3309 3309 3309 3309 3309 3309 3309 3309 3309 3309 3309 3309 -1
153 154 5183 5183 5183 5595 5596 5597 5598 5183 5583 5584 5583 5584 5583 5584 5583 5584 5583 5584 -1 -1 5182 5181 4887 4888 4889 5181 5182 -1 -1 -1 -1 5685 -1 -1 -1 -1 5685 -1 5666 5667 3309 3309 3309 3309 3309 -1 -1 -1 -1 -1 -1 3309 3309 3309 3309 3309 5666 5667
5785 5785 -1 -1 -1 5785 5785 5785 5785 -1 5683 5684 5683 5684 5683 5684 5683 5684 5683 5684 -1 -1 -1 -1 -1 -1 -1 -1 -1 -1 -1 -1 -1 -1 -1 -1 -1 -1 -1 -1 5766 5767 -1 -1 -1 -1 -1 -1 -1 -1 -1 -1 -1 -1 -1 -1 -1 -1 5766 5767
-1 -1 -1 -1 -1 -1 -1 -1 -1 -1 -1 -1 -1 -1 -1 -1 -1 -1 -1 -1 -1 -1 -1 -1 -1 -1 -1 -1 -1 -1 -1 -1 -1 -1 -1 -1 -1 -1 -1 -1 5666 5667 -1 -1 -1 -1 5030 -1 -1 -1 -1 -1 -1 5030 -1 5772 -1 -1 5130 5130
-1 -1 -1 -1 -1 -1 -1 -1 -1 -1 -1 -1 -1 -1 -1 -1 -1 -1 -1 -1 -1 -1 -1 -1 -1 -1 -1 -1 -1 -1 -1 -1 -1 -1 -1 -1 -1 -1 -1 -1 5766 5767 -1 -1 -1 -1 5030 -1 -1 -1 -1 -1 -1 5030 -1 -1 -1 -1 -1 -1
-1 -1 -1 -1 -1 -1 -1 -1 -1 -1 -1 -1 -1 -1 -1 -1 -1 -1 -1 -1 -1 -1 -1 -1 -1 -1 -1 -1 -1 -1 -1 -1 -1 -1 -1 -1 -1 -1 -1 -1 5666 5667 -1 -1 -1 -1 5030 -1 -1 -1 -1 -1 5133 5128 -1 -1 -1 688 689 5926
-1 -1 -1 -1 -1 -1 -1 -1 -1 -1 -1 -1 -1 -1 -1 -1 -1 -1 -1 -1 -1 -1 -1 -1 -1 -1 -1 -1 -1 -1 -1 -1 -1 -1 -1 -1 -1 -1 -1 -1 5766 5767 -1 -1 -1 -1 5030 5775 -1 -1 -1 -1 5030 -1 -1 -1 -1 788 789 6026
-1 -1 -1 -1 -1 -1 -1 -1 -1 -1 -1 -1 -1 -1 -1 -1 -1 -1 -1 -1 -1 -1 -1 -1 -1 -1 -1 -1 -1 -1 -1 -1 -1 -1 -1 -1 -1 -1 -1 -1 5666 5667 -1 -1 5673 5674 5030 -1 -1 -1 -1 -1 5030 -1 -1 -1 5763 5660 5661 5775
-1 -1 -1 -1 -1 -1 -1 -1 -1 -1 -1 -1 -1 -1 -1 -1 -1 -1 -1 -1 -1 -1 -1 -1 -1 -1 -1 -1 -1 -1 -1 -1 -1 -1 -1 -1 -1 -1 -1 -1 5766 5767 5029 5130 5130 5130 5133 5132 -1 -1 -1 -1 -1 -1 -1 -1 5763 5760 5761 5775
-1 -1 -1 -1 -1 -1 -1 -1 -1 -1 -1 -1 -1 -1 -1 -1 -1 -1 -1 -1 -1 -1 -1 -1 -1 -1 -1 -1 -1 -1 -1 -1 -1 -1 -1 -1 -1 -1 -1 -1 5666 5667 -1 -1 -1 -1 5849 5030 -1 -1 -1 -1 -1 -1 -1 -1 -1 -1 -1 -1
-1 -1 -1 -1 -1 -1 -1 -1 -1 -1 -1 -1 -1 -1 -1 -1 -1 -1 -1 -1 -1 -1 -1 -1 -1 -1 -1 -1 -1 -1 -1 -1 -1 -1 -1 -1 -1 -1 -1 -1 5766 5767 -1 -1 5772 -1 -1 5030 -1 -1 -1 -1 -1 -1 -1 -1 -1 -1 -1 -1
-1 -1 -1 -1 -1 -1 -1 -1 -1 -1 -1 -1 -1 -1 -1 -1 -1 -1 -1 -1 -1 -1 -1 -1 -1 -1 -1 -1 -1 -1 -1 -1 -1 -1 -1 -1 -1 -1 -1 -1 5666 5667 -1 -1 -1 5773 3309 5030 -1 -1 -1 -1 -1 -1 -1 690 691 690 691 5926
-1 -1 -1 -1 -1 -1 -1 -1 -1 -1 -1 -1 -1 -1 -1 -1 -1 -1 -1 -1 -1 -1 -1 -1 -1 -1 -1 -1 -1 -1 -1 -1 -1 -1 -1 -1 -1 -1 -1 -1 5766 5767 4648 4649 4650 -1 3309 5030 -1 -1 -1 -1 -1 -1 -1 790 791 790 791 6026
-1 -1 -1 -1 -1 -1 -1 -1 -1 -1 -1 -1 -1 -1 -1 -1 -1 -1 -1 -1 -1 -1 -1 -1 -1 -1 -1 -1 -1 -1 -1 -1 -1 -1 -1 -1 -1 -1 -1 -1 5666 5667 4748 4749 4750 6021 6021 5030 -1 -1 -1 -1 5030 -1 -1 -1 -1 -1 -1 -1
-1 -1 -1 -1 -1 -1 -1 -1 -1 -1 -1 -1 -1 -1 -1 -1 -1 -1 -1 -1 -1 -1 -1 -1 -1 -1 -1 -1 -1 -1 -1 -1 -1 -1 -1 -1 -1 -1 -1 -1 5766 5767 4848 4849 4850 6021 6021 5030 -1 -1 -1 -1 5030 -1 -1 -1 -1 -1 -1 -1
-1 -1 -1 -1 -1 -1 -1 -1 -1 -1 -1 -1 -1 -1 -1 -1 -1 -1 -1 -1 -1 -1 -1 -1 -1 -1 -1 -1 -1 -1 -1 -1 -1 -1 -1 -1 -1 -1 -1 -1 5666 5667 4948 4949 4950 6021 6021 5030 -1 -1 -1 -1 5031 5131 5131 5131 5131 5131 5133 -1
-1 -1 -1 -1 -1 -1 -1 -1 -1 -1 -1 -1 -1 -1 -1 -1 -1 -1 -1 -1 -1 -1 -1 -1 -1 -1 -1 -1 -1 -1 -1 -1 -1 -1 -1 -1 -1 -1 -1 -1 5766 5767 -1 -1 5772 5027 5028 5030 -1 -1 -1 -1 -1 -1 -1 5772 5773 -1 5030 -1
-1 -1 -1 -1 -1 -1 -1 -1 -1 -1 -1 -1 -1 -1 -1 -1 -1 -1 -1 -1 -1 -1 -1 -1 -1 -1 -1 -1 -1 -1 -1 -1 -1 -1 -1 -1 -1 -1 -1 -1 5666 5667 -1 -1 -1 5127 5128 5030 -1 -1 -1 -1 -1 -1 -1 -1 -1 -1 5030 -1
-1 -1 -1 -1 -1 -1 -1 -1 -1 -1 -1 -1 -1 -1 -1 -1 -1 -1 -1 -1 -1 -1 -1 -1 -1 -1 -1 -1 -1 -1 -1 -1 -1 -1 -1 -1 -1 -1 -1 -1 5766 5767 5029 5130 5130 5130 5130 5133 -1 -1 -1 -1 -1 -1 5775 -1 -1 5827 5720 5721
-1 -1 -1 -1 -1 -1 -1 -1 -1 -1 -1 -1 -1 -1 -1 -1 -1 -1 -1 -1 -1 -1 -1 -1 -1 -1 -1 -1 -1 -1 -1 -1 -1 -1 -1 -1 -1 -1 -1 -1 5666 5667 -1 -1 -1 5673 5674 5030 -1 -1 -1 -1 -1 -1 -1 -1 5827 5726 5820 5821
-1 -1 -1 -1 -1 -1 -1 -1 -1 -1 -1 -1 -1 -1 -1 -1 -1 -1 -1 -1 -1 -1 -1 -1 -1 -1 -1 -1 -1 -1 -1 -1 -1 -1 -1 -1 -1 -1 -1 -1 5766 5767 -1 4227 4228 4229 4230 5030 -1 -1 -1 -1 -1 -1 5772 -1 5827 5826 5920 5921
-1 -1 -1 -1 -1 -1 -1 -1 -1 -1 -1 -1 -1 -1 -1 -1 -1 -1 -1 -1 -1 -1 -1 -1 -1 -1 -1 -1 -1 -1 -1 -1 -1 -1 -1 -1 -1 -1 -1 -1 5666 5667 5200 4327 4328 4329 4330 5030 -1 -1 -1 -1 -1 -1 -1 -1 -1 5775 5666 5667
-1 -1 -1 -1 -1 -1 -1 -1 -1 -1 -1 -1 -1 -1 -1 -1 -1 -1 -1 -1 -1 -1 -1 -1 -1 -1 -1 -1 -1 -1 -1 -1 -1 -1 -1 -1 -1 -1 -1 -1 5766 5767 5300 4427 4428 4429 4430 5030 -1 -1 -1 -1 -1 -1 -1 -1 -1 5775 5766 5767
-1 -1 -1 -1 -1 -1 -1 -1 -1 -1 -1 -1 -1 -1 -1 -1 -1 -1 -1 -1 -1 -1 -1 -1 -1 -1 -1 -1 -1 -1 -1 -1 -1 -1 -1 -1 -1 -1 -1 -1 5556 5557 5157 5157 5556 5557 5157 5156 -1 -1 -1 -1 -1 -1 -1 -1 -1 -1 5027 5130
-1 -1 -1 -1 -1 -1 -1 -1 -1 -1 -1 -1 -1 -1 -1 -1 -1 -1 -1 -1 -1 -1 -1 -1 -1 -1 -1 -1 -1 -1 -1 -1 -1 -1 -1 -1 -1 -1 -1 -1 5656 5657 5924 5925 5656 5657 -1 5773 -1 -1 -1 -1 -1 688 689 5027 5130 5130 5128 5634
-1 -1 -1 -1 -1 -1 -1 -1 -1 -1 -1 -1 -1 -1 -1 -1 -1 -1 -1 -1 -1 -1 -1 -1 -1 -1 -1 -1 -1 -1 -1 -1 -1 -1 -1 -1 -1 -1 -1 -1 5756 5757 6024 6025 5756 5757 -1 -1 -1 -1 -1 -1 -1 788 789 -1 -1 -1 -1 5734
-1 -1 -1 -1 -1 -1 -1 -1 -1 -1 -1 -1 -1 -1 -1 -1 -1 -1 -1 -1 -1 -1 -1 -1 -1 -1 -1 -1 -1 -1 -1 -1 -1 -1 -1 -1 -1 -1 -1 -1 -1 4962 4963 4964 4965 -1 5775 -1 3303 -1 -1 -1 -1 -1 -1 -1 5772 -1 -1 -1
-1 -1 -1 -1 -1 -1 -1 -1 -1 -1 -1 -1 -1 -1 -1 -1 -1 -1 -1 -1 -1 -1 -1 -1 -1 -1 -1 -1 -1 -1 -1 -1 -1 -1 -1 -1 -1 -1 -1 -1 -1 5062 5063 5064 5065 -1 -1 -1 -1 -1 -1 -1 -1 -1 -1 -1 -1 -1 4904 4904
-1 -1 -1 -1 -1 -1 -1 -1 -1 -1 -1 -1 -1 -1 -1 -1 -1 -1 -1 -1 -1 -1 -1 -1 -1 -1 -1 -1 -1 -1 -1 -1 -1 -1 -1 -1 -1 -1 -1 -1 -1 5162 5163 5164 5165 -1 -1 5773 -1 -1 -1 -1 -1 -1 -1 -1 -1 -1 4904 4904
-1 -1 -1 -1 -1 -1 -1 -1 -1 -1 -1 -1 -1 -1 -1 -1 -1 -1 -1 -1 -1 -1 -1 -1 -1 -1 -1 -1 -1 -1 -1 -1 -1 -1 -1 -1 -1 -1 -1 -1 -1 5262 5263 5264 5265 -1 -1 -1 -1 -1 -1 -1 -1 3303 -1 -1 -1 -1 4625 4626
-1 -1 -1 -1 -1 -1 -1 -1 -1 -1 -1 -1 -1 -1 -1 -1 -1 -1 -1 -1 -1 -1 -1 -1 -1 -1 -1 -1 -1 -1 -1 -1 -1 -1 -1 -1 -1 -1 -1 -1 -1 -1 5156 -1 -1 -1 -1 -1 -1 -1 -1 -1 -1 -1 -1 4956 4957 -1 -1 4707
-1 -1 -1 -1 -1 -1 -1 -1 -1 -1 -1 -1 -1 -1 -1 -1 -1 -1 -1 -1 -1 -1 -1 -1 -1 -1 -1 -1 -1 -1 -1 -1 -1 -1 -1 -1 -1 -1 -1 -1 5666 5667 -1 -1 -1 -1 -1 3303 -1 3303 -1 -1 -1 5773 -1 5056 5057 -1 5666 5667
-1 -1 -1 -1 -1 -1 -1 -1 -1 -1 -1 -1 -1 -1 -1 -1 -1 -1 -1 -1 -1 -1 -1 -1 -1 -1 -1 -1 -1 -1 -1 -1 -1 -1 -1 -1 -1 -1 -1 -1 5766 5767 -1 -1 -1 -1 -1 -1 -1 -1 -1 -1 -1 -1 -1 -1 -1 -1 5766 5767
-1 -1 -1 -1 -1 -1 -1 -1 -1 -1 -1 -1 -1 -1 -1 -1 -1 -1 -1 -1 -1 -1 -1 -1 -1 -1 -1 -1 -1 -1 -1 -1 -1 -1 -1 -1 -1 -1 -1 -1 -1 -1 -1 -1 5450 5451 -1 -1 5775 -1 -1 -1 -1 -1 -1 -1 5774 -1 5666 5667
-1 -1 -1 -1 -1 -1 -1 -1 -1 -1 -1 -1 -1 -1 -1 -1 -1 -1 -1 -1 -1 -1 -1 -1 -1 -1 -1 -1 -1 -1 -1 -1 -1 -1 -1 -1 -1 -1 -1 -1 -1 -1 5772 -1 5550 5551 -1 -1 -1 -1 -1 -1 -1 5774 -1 -1 -1 -1 5766 5767
-1 -1 -1 -1 -1 -1 -1 -1 -1 -1 -1 -1 -1 -1 -1 -1 -1 -1 -1 -1 -1 -1 -1 -1 -1 -1 -1 -1 -1 -1 -1 -1 -1 -1 -1 -1 -1 -1 -1 -1 -1 -1 -1 5719 5650 5651 5719 -1 -1 -1 -1 -1 -1 -1 -1 6241 5658 5659 5658 5659
-1 -1 -1 -1 -1 -1 -1 -1 -1 -1 -1 -1 -1 -1 -1 -1 -1 -1 -1 -1 -1 -1 -1 -1 -1 -1 -1 -1 -1 -1 -1 -1 -1 -1 -1 -1 -1 -1 -1 -1 5660 5661 -1 5819 5924 5925 5819 -1 -1 -1 -1 -1 -1 -1 -1 6341 5758 5759 5758 5759
-1 -1 -1 -1 -1 -1 -1 -1 -1 -1 -1 -1 -1 -1 -1 -1 -1 -1 -1 -1 -1 -1 -1 -1 -1 -1 -1 -1 -1 -1 -1 -1 -1 -1 -1 -1 -1 -1 -1 -1 5760 5761 -1 5919 6024 6025 5919 -1 -1 -1 -1 -1 -1 -1 -1 -1 -1 5373 5374 5375
-1 -1 -1 -1 -1 -1 -1 -1 -1 -1 -1 -1 -1 -1 -1 -1 -1 -1 -1 -1 -1 -1 -1 -1 -1 -1 -1 -1 -1 -1 -1 -1 -1 -1 -1 -1 -1 -1 -1 -1 5030 -1 -1 -1 -1 -1 -1 -1 -1 -1 -1 -1 -1 -1 -1 -1 -1 5473 5474 5475
-1 -1 -1 -1 -1 -1 -1 -1 -1 -1 -1 -1 -1 -1 -1 -1 -1 -1 -1 -1 -1 -1 -1 -1 -1 -1 -1 -1 -1 -1 -1 -1 -1 -1 -1 -1 -1 -1 -1 -1 5030 -1 -1 -1 -1 -1 -1 -1 -1 -1 -1 -1 -1 -1 -1 -1 -1 5573 5574 5575
-1 -1 -1 -1 -1 -1 -1 -1 -1 -1 -1 -1 -1 -1 -1 -1 -1 -1 -1 -1 -1 -1 -1 -1 -1 -1 -1 -1 -1 -1 -1 -1 -1 -1 -1 -1 -1 -1 -1 -1 5030 5440 5030 288 289 5772 -1 -1 -1 -1 -1 -1 -1 5775 -1 6241 5660 5661 5660 5661
-1 -1 -1 -1 -1 -1 -1 -1 -1 -1 -1 -1 -1 -1 -1 -1 -1 -1 -1 -1 -1 -1 -1 -1 -1 -1 -1 -1 -1 -1 -1 -1 -1 -1 -1 -1 -1 -1 -1 -1 5127 5130 5128 388 389 -1 -1 -1 -1 -1 -1 -1 -1 -1 -1 6341 5760 5761 5760 5761
-1 -1 -1 -1 -1 -1 -1 -1 -1 -1 -1 -1 -1 -1 -1 -1 -1 -1 -1 -1 -1 -1 -1 -1 -1 -1 -1 -1 -1 -1 -1 -1 -1 -1 -1 -1 -1 -1 -1 -1 -1 -1 -1 -1 -1 -1 -1 -1 -1 -1 -1 -1 -1 -1 -1 -1 -1 -1 -1 -1
-1 -1 -1 -1 -1 -1 -1 -1 -1 -1 -1 -1 -1 -1 -1 -1 -1 -1 -1 -1 -1 -1 -1 -1 -1 -1 -1 -1 -1 -1 -1 -1 -1 -1 -1 -1 -1 -1 -1 -1 -1 -1 -1 -1 -1 -1 5773 -1 -1 -1 -1 -1 -1 -1 -1 -1 -1 -1 -1 -1
-1 -1 -1 -1 -1 -1 -1 -1 -1 -1 -1 -1 -1 -1 -1 -1 -1 -1 -1 -1 -1 -1 -1 -1 -1 -1 -1 -1 -1 -1 -1 -1 -1 -1 -1 -1 -1 -1 -1 -1 -1 5158 5159 5160 5161 -1 -1 -1 -1 -1 -1 -1 -1 -1 5070 5071 5072 5073 5074 5075
-1 -1 -1 -1 -1 -1 -1 -1 -1 -1 -1 -1 -1 -1 -1 -1 -1 -1 -1 -1 -1 -1 -1 -1 -1 -1 -1 -1 -1 -1 -1 -1 -1 -1 -1 -1 -1 -1 -1 -1 -1 5258 5259 5260 5261 -1 -1 -1 -1 -1 -1 -1 -1 -1 5170 5171 5172 5173 5174 5175
-1 -1 -1 -1 -1 -1 -1 -1 -1 -1 -1 -1 -1 -1 -1 -1 -1 -1 -1 -1 -1 -1 -1 -1 -1 -1 -1 -1 -1 -1 -1 -1 -1 -1 -1 -1 -1 -1 -1 -1 -1 5358 5359 5360 5361 5562 5563 -1 -1 -1 -1 -1 5774 -1 5270 5271 5272 5273 5274 5275
-1 -1 -1 -1 -1 -1 -1 -1 -1 -1 -1 -1 -1 -1 -1 -1 -1 -1 -1 -1 -1 -1 -1 -1 -1 -1 -1 -1 -1 -1 -1 -1 -1 -1 -1 -1 -1 -1 -1 -1 -1 5458 5459 5460 5461 5662 5663 -1 -1 -1 -1 -1 -1 -1 5370 5371 5372 -1 -1 6241
-1 -1 -1 -1 -1 -1 -1 -1 -1 -1 -1 -1 -1 -1 -1 -1 -1 -1 -1 -1 -1 -1 -1 -1 -1 -1 -1 -1 -1 -1 -1 -1 -1 -1 -1 -1 -1 -1 -1 -1 -1 5558 5559 5560 5561 -1 5763 -1 -1 -1 -1 -1 -1 -1 5470 5471 5472 5763 5762 6341
-1 -1 -1 -1 -1 -1 -1 -1 -1 -1 -1 -1 -1 -1 -1 -1 -1 -1 -1 -1 -1 -1 -1 -1 -1 -1 -1 -1 -1 -1 -1 -1 -1 -1 -1 -1 -1 -1 -1 -1 -1 -1 -1 -1 -1 -1 -1 -1 -1 -1 -1 -1 -1 -1 5570 5571 5572 -1 -1 -1
-1 -1 -1 -1 -1 -1 -1 -1 -1 -1 -1 -1 -1 -1 -1 -1 -1 -1 -1 -1 -1 -1 -1 -1 -1 -1 -1 -1 -1 -1 -1 -1 -1 -1 -1 -1 -1 -1 -1 -1 -1 -1 5772 -1 -1 -1 -1 -1 -1 -1 -1 -1 -1 -1 -1 5671 5048 5049 -1 -1
-1 -1 -1 -1 -1 -1 -1 -1 -1 -1 -1 -1 -1 -1 -1 -1 -1 -1 -1 -1 -1 -1 -1 -1 -1 -1 -1 -1 -1 -1 -1 -1 -1 -1 -1 -1 -1 -1 -1 -1 -1 -1 -1 -1 -1 -1 -1 -1 -1 -1 -1 -1 -1 -1 -1 5771 5148 5149 -1 -1
-1 -1 -1 -1 -1 -1 -1 -1 -1 -1 -1 -1 -1 -1 -1 -1 -1 -1 -1 -1 -1 -1 -1 -1 -1 -1 -1 -1 -1 -1 -1 -1 -1 -1 -1 -1 -1 -1 -1 -1 -1 -1 -1 -1 -1 -1 5773 -1 -1 -1 -1 -1 -1 -1 -1 5671 4706 4706 -1 -1
-1 -1 -1 -1 -1 -1 -1 -1 -1 -1 -1 -1 -1 -1 -1 -1 -1 -1 -1 -1 -1 -1 -1 -1 -1 -1 -1 -1 -1 -1 -1 -1 -1 -1 -1 -1 -1 -1 -1 -1 5156 5157 5157 5157 5157 5157 5156 -1 -1 -1 -1 -1 -1 -1 -1 5771 4706 4706 -1 -1
-1 -1 -1 -1 -1 -1 -1 -1 -1 -1 -1 -1 -1 -1 -1 -1 -1 -1 -1 -1 -1 -1 -1 -1 -1 -1 -1 -1 -1 -1 -1 -1 -1 -1 -1 -1 -1 -1 -1 -1 -1 5774 -1 -1 -1 -1 -1 -1 -1 -1 -1 -1 -1 -1 -1 5671 5666 5667 -1 -1
-1 -1 -1 -1 -1 -1 -1 -1 -1 -1 -1 -1 -1 -1 -1 -1 -1 -1 -1 -1 -1 -1 -1 -1 -1 -1 -1 -1 -1 -1 -1 -1 -1 -1 -1 -1 -1 -1 -1 -1 -1 -1 -1 -1 -1 -1 -1 -1 -1 -1 -1 -1 -1 5774 -1 5771 5766 5767 -1 -1
-1 -1 -1 -1 -1 -1 -1 -1 -1 -1 -1 -1 -1 -1 -1 -1 -1 -1 -1 -1 -1 -1 -1 -1 -1 -1 -1 -1 -1 -1 -1 -1 -1 -1 -1 -1 -1 -1 -1 -1 -1 -1 2901 2802 2802 -1 -1 -1 -1 -1 -1 -1 -1 5666 5667 5671 5666 5667 -1 -1
-1 -1 -1 -1 -1 -1 -1 -1 -1 -1 -1 -1 -1 -1 -1 -1 -1 -1 -1 -1 -1 -1 -1 -1 -1 -1 -1 -1 -1 -1 -1 -1 -1 -1 -1 -1 -1 -1 -1 -1 -1 -1 2900 5002 5003 -1 -1 -1 -1 -1 -1 -1 -1 5766 5767 5771 5766 5767 -1 -1
-1 -1 -1 -1 -1 -1 -1 -1 -1 -1 -1 -1 -1 -1 -1 -1 -1 -1 -1 -1 -1 -1 -1 -1 -1 -1 -1 -1 -1 -1 -1 -1 -1 -1 -1 -1 -1 -1 -1 -1 -1 -1 2900 5102 5103 -1 -1 -1 -1 -1 -1 -1 -1 -1 -1 5671 5666 5667 -1 6241
-1 -1 -1 -1 -1 -1 -1 -1 -1 -1 -1 -1 -1 -1 -1 -1 -1 -1 -1 -1 -1 -1 -1 -1 -1 -1 -1 -1 -1 -1 -1 -1 -1 -1 -1 -1 -1 -1 -1 -1 -1 -1 3001 2802 2802 5006 -1 -1 -1 -1 -1 -1 -1 -1 -1 5771 5766 5767 -1 6341
-1 -1 -1 -1 -1 -1 -1 -1 -1 -1 -1 -1 -1 -1 -1 -1 -1 -1 -1 -1 -1 -1 -1 -1 -1 -1 -1 -1 -1 -1 -1 -1 -1 -1 -1 -1 -1 -1 -1 -1 -1 -1 -1 -1 -1 5106 -1 -1 -1 -1 -1 -1 -1 5666 5667 5671 4800 4811 4812 4813
-1 -1 -1 -1 -1 -1 -1 -1 -1 -1 -1 -1 -1 -1 -1 -1 -1 -1 -1 -1 -1 -1 -1 -1 -1 -1 -1 -1 -1 -1 -1 -1 -1 -1 -1 -1 -1 -1 -1 -1 -1 -1 -1 -1 -1 -1 -1 -1 5774 -1 -1 -1 -1 5766 5767 5671 5200 5200 5200 5200
-1 -1 -1 -1 -1 -1 -1 -1 -1 -1 -1 -1 -1 -1 -1 -1 -1 -1 -1 -1 -1 -1 -1 -1 -1 -1 -1 -1 -1 -1 -1 -1 -1 -1 -1 -1 -1 -1 -1 -1 -1 -1 -1 -1 -1 -1 -1 -1 -1 -1 -1 -1 -1 -1 -1 5771 5300 5300 5300 5300

