TILEMAP
60 80
16 16
images/TilesetGlobal.png
100 88
711 712 712 712 712 712 712 712 712 712 712 712 712 712 712 712 712 712 712 712 712 712 712 712 712 712 712 712 712 712 712 712 712 712 712 712 712 712 712 712 712 712 712 712 712 712 712 712 712 712 712 712 712 712 712 712 712 712 712 713
811 812 812 812 812 812 812 812 812 812 812 812 812 812 812 812 812 812 812 812 812 812 812 812 812 812 812 812 812 812 812 812 812 812 812 812 812 812 812 812 812 812 812 812 812 812 812 812 812 812 812 812 812 812 812 812 812 812 812 813
811 812 812 812 812 812 812 816 817 812 812 812 812 812 812 812 812 812 812 812 812 812 812 812 812 812 812 816 817 812 812 812 812 812 812 812 812 812 812 812 812 812 812 812 812 812 812 816 817 812 812 812 812 812 812 812 812 812 812 813
811 812 812 1111 812 812 812 916 917 812 812 816 817 812 812 812 812 812 812 812 812 812 812 1111 812 812 812 916 917 812 812 816 817 812 812 812 812 812 812 812 812 812 812 1111 812 812 812 916 917 812 812 816 817 812 812 812 812 812 812 813
811 812 812 812 812 812 812 812 812 812 812 916 917 812 812 812 812 812 812 812 812 812 812 812 812 812 812 812 812 812 812 916 917 812 812 812 812 812 812 812 812 812 812 812 812 812 812 812 812 812 812 916 917 812 812 812 812 812 812 813
811 812 812 812 812 812 812 812 812 812 812 812 812 812 812 812 812 812 812 812 812 812 812 812 812 812 812 812 812 812 812 812 812 812 812 812 812 812 812 812 812 812 812 812 812 812 812 812 812 812 812 812 812 812 812 812 812 812 812 813
811 812 812 812 812 812 812 812 812 812 812 812 812 812 812 812 812 812 812 812 812 812 812 812 812 812 812 812 812 812 812 812 812 812 812 812 812 812 812 812 812 812 812 812 812 812 812 812 812 812 812 812 812 812 812 812 812 812 812 813
811 812 812 812 812 812 812 812 812 812 812 812 812 812 812 812 812 812 812 812 812 812 812 812 812 812 812 812 812 812 812 812 812 812 812 812 812 812 812 812 812 812 812 812 812 812 812 812 812 812 812 812 812 812 812 812 812 812 812 813
811 812 812 812 812 812 1111 812 812 812 812 812 812 812 812 812 812 812 812 812 812 812 812 812 812 812 1111 812 812 812 812 812 812 812 812 812 812 812 812 812 812 812 812 812 812 812 1111 812 812 812 812 812 812 812 812 812 812 812 812 813
811 812 812 812 812 812 812 812 812 812 812 812 812 812 812 812 812 812 812 812 812 812 812 812 812 812 812 812 812 812 812 812 812 812 812 812 812 812 812 812 812 812 812 812 812 812 812 812 812 812 812 812 812 812 812 812 812 812 812 813
811 812 812 812 812 812 812 812 812 812 812 812 812 812 812 812 812 812 812 812 812 812 812 812 812 812 812 812 812 812 812 812 812 812 812 812 812 812 812 812 812 812 812 812 812 812 812 812 812 812 812 812 812 812 812 812 812 812 812 813
811 812 812 812 812 812 812 812 812 812 812 816 817 812 812 812 812 812 812 812 812 812 812 812 812 812 812 812 812 812 812 816 817 812 812 812 812 812 812 812 812 812 812 812 812 812 812 812 812 812 812 816 817 812 812 812 812 812 812 813
811 812 812 812 816 817 812 812 812 812 812 916 917 812 812 812 812 812 812 812 812 812 812 812 816 817 812 812 812 812 812 916 917 812 812 812 812 812 812 812 812 812 812 812 816 817 812 812 812 812 812 916 917 812 812 812 812 812 812 813
811 812 812 812 916 917 812 812 812 812 812 812 812 812 812 812 812 812 812 812 812 812 812 812 916 917 812 812 812 812 812 812 812 812 812 812 812 812 812 812 812 812 812 812 916 917 812 812 812 812 812 812 812 812 812 812 812 812 812 813
811 812 812 812 812 812 812 812 812 812 812 812 812 812 812 812 812 812 812 812 812 812 812 812 812 812 812 812 812 812 812 812 812 812 812 812 812 812 812 812 812 812 812 812 812 812 812 812 812 812 812 812 812 812 812 812 812 812 812 813
811 812 812 812 812 812 812 812 812 812 812 812 812 812 812 812 812 812 812 812 812 812 812 812 812 812 812 812 812 812 812 812 812 812 812 812 812 812 812 812 812 812 812 812 812 812 812 812 812 812 812 812 812 812 812 812 812 812 812 813
811 812 812 812 812 812 812 812 1111 812 812 812 812 812 812 812 812 812 812 812 812 812 812 812 812 812 812 812 1111 812 812 812 812 812 812 812 812 812 812 812 812 812 812 812 812 812 812 812 1111 812 812 812 812 812 812 812 812 812 812 813
811 812 812 812 812 812 812 812 812 812 812 812 812 812 812 812 812 812 812 812 812 812 812 812 812 812 812 812 812 812 812 812 812 812 812 812 812 812 812 812 812 812 812 812 812 812 812 812 812 812 812 812 812 812 812 812 812 812 812 813
811 812 812 816 817 812 812 812 812 812 812 812 812 812 812 812 812 812 812 812 812 812 812 816 817 812 812 812 812 812 812 812 812 812 812 812 812 812 812 812 812 812 812 812 812 812 812 101 101 105 106 101 101 812 812 812 812 812 812 813
911 912 912 912 912 912 912 912 912 912 912 912 912 912 912 912 912 912 912 912 912 912 912 912 912 912 912 912 912 912 912 912 912 912 912 912 912 912 912 912 101 101 401 101 101 101 101 101 101 205 206 101 101 101 101 101 101 101 401 102
-1 -1 -1 -1 -1 -1 -1 -1 -1 -1 -1 -1 -1 -1 -1 -1 -1 -1 -1 -1 -1 -1 -1 -1 -1 -1 -1 -1 -1 -1 -1 -1 -1 -1 -1 -1 -1 -1 -1 -1 100 101 101 101 101 101 101 101 101 101 101 101 101 101 101 101 101 101 101 102
-1 -1 -1 -1 -1 -1 -1 -1 -1 -1 -1 -1 -1 -1 -1 -1 -1 -1 -1 -1 -1 -1 -1 -1 -1 -1 -1 -1 -1 -1 -1 -1 -1 -1 -1 -1 -1 -1 -1 -1 100 101 2233 2234 2235 101 101 101 101 101 101 101 101 101 101 101 101 101 101 102
-1 -1 -1 -1 -1 -1 -1 -1 -1 -1 -1 -1 -1 -1 -1 -1 -1 -1 -1 -1 -1 -1 -1 -1 -1 -1 -1 -1 -1 -1 -1 -1 -1 -1 -1 -1 -1 -1 -1 -1 100 101 2333 2334 2335 101 101 101 101 101 101 101 101 101 101 101 101 101 101 102
-1 -1 -1 -1 -1 -1 -1 -1 -1 -1 -1 -1 -1 -1 -1 -1 -1 -1 -1 -1 -1 -1 -1 -1 -1 -1 -1 -1 -1 -1 -1 -1 -1 -1 -1 -1 -1 -1 -1 -1 100 101 2433 2434 2435 101 101 101 101 101 101 101 101 101 101 101 101 101 101 102
-1 -1 -1 -1 -1 -1 -1 -1 -1 -1 -1 -1 -1 -1 -1 -1 -1 -1 -1 -1 -1 -1 -1 -1 -1 -1 -1 -1 -1 -1 -1 -1 -1 -1 -1 -1 -1 -1 -1 -1 100 101 101 101 101 101 101 101 101 101 101 101 101 101 101 101 101 101 101 102
-1 -1 -1 -1 -1 -1 -1 -1 -1 -1 -1 -1 -1 -1 -1 -1 -1 -1 -1 -1 -1 -1 -1 -1 -1 -1 -1 -1 -1 -1 -1 -1 -1 -1 -1 -1 -1 -1 -1 -1 100 101 101 101 101 101 101 101 101 101 101 101 101 101 101 101 101 101 101 102
-1 -1 -1 -1 -1 -1 -1 -1 -1 -1 -1 -1 -1 -1 -1 -1 -1 -1 -1 -1 -1 -1 -1 -1 -1 -1 -1 -1 -1 -1 -1 -1 -1 -1 -1 -1 -1 -1 -1 -1 100 101 101 101 101 101 101 101 101 101 101 400 101 101 101 101 101 101 101 102
-1 -1 -1 -1 -1 -1 -1 -1 -1 -1 -1 -1 -1 -1 -1 -1 -1 -1 -1 -1 -1 -1 -1 -1 -1 -1 -1 -1 -1 -1 -1 -1 -1 -1 -1 -1 -1 -1 -1 -1 100 101 101 101 101 101 101 101 101 101 101 101 101 101 101 101 101 101 101 102
-1 -1 -1 -1 -1 -1 -1 -1 -1 -1 -1 -1 -1 -1 -1 -1 -1 -1 -1 -1 -1 -1 -1 -1 -1 -1 -1 -1 -1 -1 -1 -1 -1 -1 -1 -1 -1 -1 -1 -1 100 101 101 101 101 101 101 101 101 101 101 101 101 101 101 101 101 101 101 102
-1 -1 -1 -1 -1 -1 -1 -1 -1 -1 -1 -1 -1 -1 -1 -1 -1 -1 -1 -1 -1 -1 -1 -1 -1 -1 -1 -1 -1 -1 -1 -1 -1 -1 -1 -1 -1 -1 -1 -1 100 101 101 101 101 101 101 101 101 101 101 101 101 101 101 101 101 101 101 102
-1 -1 -1 -1 -1 -1 -1 -1 -1 -1 -1 -1 -1 -1 -1 -1 -1 -1 -1 -1 -1 -1 -1 -1 -1 -1 -1 -1 -1 -1 -1 -1 -1 -1 -1 -1 -1 -1 -1 -1 100 101 101 101 101 101 101 101 101 101 101 101 101 101 101 101 101 101 101 102
-1 -1 -1 -1 -1 -1 -1 -1 -1 -1 -1 -1 -1 -1 -1 -1 -1 -1 -1 -1 -1 -1 -1 -1 -1 -1 -1 -1 -1 -1 -1 -1 -1 -1 -1 -1 -1 -1 -1 -1 100 101 101 101 101 101 101 101 101 101 101 101 101 101 101 101 101 101 101 102
-1 -1 -1 -1 -1 -1 -1 -1 -1 -1 -1 -1 -1 -1 -1 -1 -1 -1 -1 -1 -1 -1 -1 -1 -1 -1 -1 -1 -1 -1 -1 -1 -1 -1 -1 -1 -1 -1 -1 -1 100 101 101 101 101 101 101 101 101 101 101 101 101 101 101 101 101 101 101 102
-1 -1 -1 -1 -1 -1 -1 -1 -1 -1 -1 -1 -1 -1 -1 -1 -1 -1 -1 -1 -1 -1 -1 -1 -1 -1 -1 -1 -1 -1 -1 -1 -1 -1 -1 -1 -1 -1 -1 -1 100 101 101 101 101 101 101 101 400 101 101 101 101 101 101 101 101 101 101 102
-1 -1 -1 -1 -1 -1 -1 -1 -1 -1 -1 -1 -1 -1 -1 -1 -1 -1 -1 -1 -1 -1 -1 -1 -1 -1 -1 -1 -1 -1 -1 -1 -1 -1 -1 -1 -1 -1 -1 -1 100 101 101 101 101 101 101 101 101 101 101 400 101 101 101 101 101 101 101 102
-1 -1 -1 -1 -1 -1 -1 -1 -1 -1 -1 -1 -1 -1 -1 -1 -1 -1 -1 -1 -1 -1 -1 -1 -1 -1 -1 -1 -1 -1 -1 -1 -1 -1 -1 -1 -1 -1 -1 -1 100 101 101 101 101 101 101 101 101 101 400 101 101 101 101 101 101 101 101 102
-1 -1 -1 -1 -1 -1 -1 -1 -1 -1 -1 -1 -1 -1 -1 -1 -1 -1 -1 -1 -1 -1 -1 -1 -1 -1 -1 -1 -1 -1 -1 -1 -1 -1 -1 -1 -1 -1 -1 -1 100 101 101 101 101 101 101 101 101 101 101 101 101 101 101 101 101 101 101 102
-1 -1 -1 -1 -1 -1 -1 -1 -1 -1 -1 -1 -1 -1 -1 -1 -1 -1 -1 -1 -1 -1 -1 -1 -1 -1 -1 -1 -1 -1 -1 -1 -1 -1 -1 -1 -1 -1 -1 -1 100 101 101 101 101 101 101 101 101 101 101 101 101 101 101 101 101 101 101 102
-1 -1 -1 -1 -1 -1 -1 -1 -1 -1 -1 -1 -1 -1 -1 -1 -1 -1 -1 -1 -1 -1 -1 -1 -1 -1 -1 -1 -1 -1 -1 -1 -1 -1 -1 -1 -1 -1 -1 -1 100 101 101 101 101 101 101 101 101 400 101 101 400 101 101 101 101 101 101 102
-1 -1 -1 -1 -1 -1 -1 -1 -1 -1 -1 -1 -1 -1 -1 -1 -1 -1 -1 -1 -1 -1 -1 -1 -1 -1 -1 -1 -1 -1 -1 -1 -1 -1 -1 -1 -1 -1 -1 -1 100 101 101 101 101 101 101 101 101 101 101 101 101 101 101 101 101 101 101 102
-1 -1 -1 -1 -1 -1 -1 -1 -1 -1 -1 -1 -1 -1 -1 -1 -1 -1 -1 -1 -1 -1 -1 -1 -1 -1 -1 -1 -1 -1 -1 -1 -1 -1 -1 -1 -1 -1 -1 -1 100 101 101 101 101 101 101 101 101 101 101 101 101 101 101 101 101 101 101 102
-1 -1 -1 -1 -1 -1 -1 -1 -1 -1 -1 -1 -1 -1 -1 -1 -1 -1 -1 -1 -1 -1 -1 -1 -1 -1 -1 -1 -1 -1 -1 -1 -1 -1 -1 -1 -1 -1 -1 -1 100 101 101 101 101 101 101 101 101 101 101 101 101 101 101 101 101 101 101 102
-1 -1 -1 -1 -1 -1 -1 -1 -1 -1 -1 -1 -1 -1 -1 -1 -1 -1 -1 -1 -1 -1 -1 -1 -1 -1 -1 -1 -1 -1 -1 -1 -1 -1 -1 -1 -1 -1 -1 -1 100 101 101 101 101 101 101 101 101 101 101 101 101 101 101 101 101 101 101 102
-1 -1 -1 -1 -1 -1 -1 -1 -1 -1 -1 -1 -1 -1 -1 -1 -1 -1 -1 -1 -1 -1 -1 -1 -1 -1 -1 -1 -1 -1 -1 -1 -1 -1 -1 -1 -1 -1 -1 -1 100 101 101 101 101 101 101 101 101 101 101 101 101 101 101 101 101 101 101 102
-1 -1 -1 -1 -1 -1 -1 -1 -1 -1 -1 -1 -1 -1 -1 -1 -1 -1 -1 -1 -1 -1 -1 -1 -1 -1 -1 -1 -1 -1 -1 -1 -1 -1 -1 -1 -1 -1 -1 -1 100 101 101 101 101 101 101 101 101 101 101 101 101 101 101 101 101 101 101 102
-1 -1 -1 -1 -1 -1 -1 -1 -1 -1 -1 -1 -1 -1 -1 -1 -1 -1 -1 -1 -1 -1 -1 -1 -1 -1 -1 -1 -1 -1 -1 -1 -1 -1 -1 -1 -1 -1 -1 -1 100 101 101 101 101 101 101 101 101 101 101 101 101 101 101 101 101 101 101 102
-1 -1 -1 -1 -1 -1 -1 -1 -1 -1 -1 -1 -1 -1 -1 -1 -1 -1 -1 -1 -1 -1 -1 -1 -1 -1 -1 -1 -1 -1 -1 -1 -1 -1 -1 -1 -1 -1 -1 -1 100 101 101 101 101 101 101 101 101 101 101 101 101 101 101 101 101 101 101 102
-1 -1 -1 -1 -1 -1 -1 -1 -1 -1 -1 -1 -1 -1 -1 -1 -1 -1 -1 -1 -1 -1 -1 -1 -1 -1 -1 -1 -1 -1 -1 -1 -1 -1 -1 -1 -1 -1 -1 -1 100 101 101 101 101 101 101 101 101 101 101 101 101 101 101 101 101 101 101 102
-1 -1 -1 -1 -1 -1 -1 -1 -1 -1 -1 -1 -1 -1 -1 -1 -1 -1 -1 -1 -1 -1 -1 -1 -1 -1 -1 -1 -1 -1 -1 -1 -1 -1 -1 -1 -1 -1 -1 -1 100 101 101 101 101 101 101 101 101 101 101 101 101 101 101 101 101 101 101 102
-1 -1 -1 -1 -1 -1 -1 -1 -1 -1 -1 -1 -1 -1 -1 -1 -1 -1 -1 -1 -1 -1 -1 -1 -1 -1 -1 -1 -1 -1 -1 -1 -1 -1 -1 -1 -1 -1 -1 -1 100 101 101 101 101 101 101 101 101 101 101 101 101 101 101 101 101 101 101 102
-1 -1 -1 -1 -1 -1 -1 -1 -1 -1 -1 -1 -1 -1 -1 -1 -1 -1 -1 -1 -1 -1 -1 -1 -1 -1 -1 -1 -1 -1 -1 -1 -1 -1 -1 -1 -1 -1 -1 -1 100 101 101 101 101 101 101 101 101 101 101 101 101 101 101 101 101 101 101 102
-1 -1 -1 -1 -1 -1 -1 -1 -1 -1 -1 -1 -1 -1 -1 -1 -1 -1 -1 -1 -1 -1 -1 -1 -1 -1 -1 -1 -1 -1 -1 -1 -1 -1 -1 -1 -1 -1 -1 -1 100 101 101 101 101 101 101 101 101 101 101 101 101 101 101 101 101 101 101 102
-1 -1 -1 -1 -1 -1 -1 -1 -1 -1 -1 -1 -1 -1 -1 -1 -1 -1 -1 -1 -1 -1 -1 -1 -1 -1 -1 -1 -1 -1 -1 -1 -1 -1 -1 -1 -1 -1 -1 -1 100 101 101 101 101 101 101 101 101 101 101 101 101 101 101 101 101 101 101 102
-1 -1 -1 -1 -1 -1 -1 -1 -1 -1 -1 -1 -1 -1 -1 -1 -1 -1 -1 -1 -1 -1 -1 -1 -1 -1 -1 -1 -1 -1 -1 -1 -1 -1 -1 -1 -1 -1 -1 -1 100 101 101 101 101 101 101 101 101 101 101 101 101 101 101 101 101 101 101 102
-1 -1 -1 -1 -1 -1 -1 -1 -1 -1 -1 -1 -1 -1 -1 -1 -1 -1 -1 -1 -1 -1 -1 -1 -1 -1 -1 -1 -1 -1 -1 -1 -1 -1 -1 -1 -1 -1 -1 -1 100 101 101 101 101 101 101 101 101 101 101 101 101 101 101 101 101 101 101 102
-1 -1 -1 -1 -1 -1 -1 -1 -1 -1 -1 -1 -1 -1 -1 -1 -1 -1 -1 -1 -1 -1 -1 -1 -1 -1 -1 -1 -1 -1 -1 -1 -1 -1 -1 -1 -1 -1 -1 -1 100 101 101 101 101 101 101 101 101 101 101 101 101 101 101 101 101 101 101 102
-1 -1 -1 -1 -1 -1 -1 -1 -1 -1 -1 -1 -1 -1 -1 -1 -1 -1 -1 -1 -1 -1 -1 -1 -1 -1 -1 -1 -1 -1 -1 -1 -1 -1 -1 -1 -1 -1 -1 -1 100 101 101 101 101 101 101 101 101 101 101 101 101 101 101 101 101 101 101 102
-1 -1 -1 -1 -1 -1 -1 -1 -1 -1 -1 -1 -1 -1 -1 -1 -1 -1 -1 -1 -1 -1 -1 -1 -1 -1 -1 -1 -1 -1 -1 -1 -1 -1 -1 -1 -1 -1 -1 -1 100 101 101 101 101 101 101 101 101 101 101 101 101 101 101 101 101 101 101 102
-1 -1 -1 -1 -1 -1 -1 -1 -1 -1 -1 -1 -1 -1 -1 -1 -1 -1 -1 -1 -1 -1 -1 -1 -1 -1 -1 -1 -1 -1 -1 -1 -1 -1 -1 -1 -1 -1 -1 -1 100 101 101 101 101 101 101 101 101 101 101 101 101 101 101 101 101 101 101 102
-1 -1 -1 -1 -1 -1 -1 -1 -1 -1 -1 -1 -1 -1 -1 -1 -1 -1 -1 -1 -1 -1 -1 -1 -1 -1 -1 -1 -1 -1 -1 -1 -1 -1 -1 -1 -1 -1 -1 -1 100 101 101 101 101 101 101 101 101 101 101 101 101 101 101 101 101 101 101 102
-1 -1 -1 -1 -1 -1 -1 -1 -1 -1 -1 -1 -1 -1 -1 -1 -1 -1 -1 -1 -1 -1 -1 -1 -1 -1 -1 -1 -1 -1 -1 -1 -1 -1 -1 -1 -1 -1 -1 -1 100 101 101 101 101 101 101 101 101 101 101 101 101 101 101 101 101 101 101 102
-1 -1 -1 -1 -1 -1 -1 -1 -1 -1 -1 -1 -1 -1 -1 -1 -1 -1 -1 -1 -1 -1 -1 -1 -1 -1 -1 -1 -1 -1 -1 -1 -1 -1 -1 -1 -1 -1 -1 -1 100 101 101 101 101 101 101 101 101 101 101 101 101 101 101 101 101 101 101 102
-1 -1 -1 -1 -1 -1 -1 -1 -1 -1 -1 -1 -1 -1 -1 -1 -1 -1 -1 -1 -1 -1 -1 -1 -1 -1 -1 -1 -1 -1 -1 -1 -1 -1 -1 -1 -1 -1 -1 -1 100 101 101 101 101 101 101 101 101 101 101 101 101 101 101 101 101 101 101 102
-1 -1 -1 -1 -1 -1 -1 -1 -1 -1 -1 -1 -1 -1 -1 -1 -1 -1 -1 -1 -1 -1 -1 -1 -1 -1 -1 -1 -1 -1 -1 -1 -1 -1 -1 -1 -1 -1 -1 -1 100 101 101 101 101 101 101 101 101 101 101 101 101 101 101 101 101 101 101 102
-1 -1 -1 -1 -1 -1 -1 -1 -1 -1 -1 -1 -1 -1 -1 -1 -1 -1 -1 -1 -1 -1 -1 -1 -1 -1 -1 -1 -1 -1 -1 -1 -1 -1 -1 -1 -1 -1 -1 -1 100 101 101 101 101 101 101 101 101 101 101 101 101 101 101 101 101 101 101 101
-1 -1 -1 -1 -1 -1 -1 -1 -1 -1 -1 -1 -1 -1 -1 -1 -1 -1 -1 -1 -1 -1 -1 -1 -1 -1 -1 -1 -1 -1 -1 -1 -1 -1 -1 -1 -1 -1 -1 -1 100 101 101 101 101 101 101 101 101 101 101 101 101 101 101 101 101 101 101 101
-1 -1 -1 -1 -1 -1 -1 -1 -1 -1 -1 -1 -1 -1 -1 -1 -1 -1 -1 -1 -1 -1 -1 -1 -1 -1 -1 -1 -1 -1 -1 -1 -1 -1 -1 -1 -1 -1 -1 -1 100 101 101 101 101 101 101 101 101 101 101 101 101 101 101 101 101 101 101 101
-1 -1 -1 -1 -1 -1 -1 -1 -1 -1 -1 -1 -1 -1 -1 -1 -1 -1 -1 -1 -1 -1 -1 -1 -1 -1 -1 -1 -1 -1 -1 -1 -1 -1 -1 -1 -1 -1 -1 -1 100 101 101 101 101 101 101 101 101 101 101 101 101 101 101 101 101 101 101 101
-1 -1 -1 -1 -1 -1 -1 -1 -1 -1 -1 -1 -1 -1 -1 -1 -1 -1 -1 -1 -1 -1 -1 -1 -1 -1 -1 -1 -1 -1 -1 -1 -1 -1 -1 -1 -1 -1 -1 -1 100 101 101 101 101 101 101 101 101 101 101 101 101 101 101 101 101 101 101 101
-1 -1 -1 -1 -1 -1 -1 -1 -1 -1 -1 -1 -1 -1 -1 -1 -1 -1 -1 -1 -1 -1 -1 -1 -1 -1 -1 -1 -1 -1 -1 -1 -1 -1 -1 -1 -1 -1 -1 -1 100 101 101 101 101 101 101 101 101 101 101 101 101 101 101 101 101 101 101 101
-1 -1 -1 -1 -1 -1 -1 -1 -1 -1 -1 -1 -1 -1 -1 -1 -1 -1 -1 -1 -1 -1 -1 -1 -1 -1 -1 -1 -1 -1 -1 -1 -1 -1 -1 -1 -1 -1 -1 -1 100 101 101 101 101 101 101 101 101 101 101 101 101 101 101 101 101 101 101 101
-1 -1 -1 -1 -1 -1 -1 -1 -1 -1 -1 -1 -1 -1 -1 -1 -1 -1 -1 -1 -1 -1 -1 -1 -1 -1 -1 -1 -1 -1 -1 -1 -1 -1 -1 -1 -1 -1 -1 -1 100 101 101 101 101 101 101 101 101 101 101 101 101 101 101 101 101 101 101 101
-1 -1 -1 -1 -1 -1 -1 -1 -1 -1 -1 -1 -1 -1 -1 -1 -1 -1 -1 -1 -1 -1 -1 -1 -1 -1 -1 -1 -1 -1 -1 -1 -1 -1 -1 -1 -1 -1 -1 -1 100 101 101 101 101 101 101 101 101 101 101 101 101 101 101 101 101 101 101 101
-1 -1 -1 -1 -1 -1 -1 -1 -1 -1 -1 -1 -1 -1 -1 -1 -1 -1 -1 -1 -1 -1 -1 -1 -1 -1 -1 -1 -1 -1 -1 -1 -1 -1 -1 -1 -1 -1 -1 -1 100 101 101 101 101 101 101 101 101 101 101 101 101 101 101 101 101 101 101 101
-1 -1 -1 -1 -1 -1 -1 -1 -1 -1 -1 -1 -1 -1 -1 -1 -1 -1 -1 -1 -1 -1 -1 -1 -1 -1 -1 -1 -1 -1 -1 -1 -1 -1 -1 -1 -1 -1 -1 -1 100 101 101 101 101 101 101 101 101 101 101 101 101 101 101 101 101 101 101 101
-1 -1 -1 -1 -1 -1 -1 -1 -1 -1 -1 -1 -1 -1 -1 -1 -1 -1 -1 -1 -1 -1 -1 -1 -1 -1 -1 -1 -1 -1 -1 -1 -1 -1 -1 -1 -1 -1 -1 -1 100 101 101 101 101 101 101 101 101 101 101 101 101 101 101 101 101 101 101 101
-1 -1 -1 -1 -1 -1 -1 -1 -1 -1 -1 -1 -1 -1 -1 -1 -1 -1 -1 -1 -1 -1 -1 -1 -1 -1 -1 -1 -1 -1 -1 -1 -1 -1 -1 -1 -1 -1 -1 -1 100 101 101 101 101 101 101 101 101 101 101 101 101 101 101 101 101 101 101 101
-1 -1 -1 -1 -1 -1 -1 -1 -1 -1 -1 -1 -1 -1 -1 -1 -1 -1 -1 -1 -1 -1 -1 -1 -1 -1 -1 -1 -1 -1 -1 -1 -1 -1 -1 -1 -1 -1 -1 -1 100 101 101 101 101 101 101 101 101 101 101 101 101 101 101 101 101 101 101 101
-1 -1 -1 -1 -1 -1 -1 -1 -1 -1 -1 -1 -1 -1 -1 -1 -1 -1 -1 -1 -1 -1 -1 -1 -1 -1 -1 -1 -1 -1 -1 -1 -1 -1 -1 -1 -1 -1 -1 -1 100 101 101 101 101 101 101 101 101 101 101 101 101 101 101 101 101 101 101 101
-1 -1 -1 -1 -1 -1 -1 -1 -1 -1 -1 -1 -1 -1 -1 -1 -1 -1 -1 -1 -1 -1 -1 -1 -1 -1 -1 -1 -1 -1 -1 -1 -1 -1 -1 -1 -1 -1 -1 -1 200 201 201 201 201 201 201 201 201 201 201 201 201 201 201 101 101 101 101 101
